111111
1EC001
100C01
1C0001
111111
