111111
1ECAP1
100C01
1C0001
111111
