111111
1ECaP1
100C01
1C0001
111111
