111111
1EC0P1
100C01
1C0101
111111
