111111
1EC0P1
100111
1C01C1
111111
