111111111111111111
1P00001E100000C001
10C000111000000001
1000000000E00000C1
100C1000C000111111
111110C000C0000001
111111111111111111
