111111
1EC0P1
101C01
1C0001
111111
