111111
1eC0P1
100C01
1C0001
111111
