111111
1EC0P1
100C01
1CP0E1
111111
