111111
eEC0P1
100C01
1C0001
111111
