111111
1E00P1
100101
110001
111111
