111111
1CC0P1
1E1111
1C01E1
111111
