111111
1EC0P1
10C01
1C0001
111111
