111111
1EC0P1
101111
1C01C1
111111
