1
111111
1EC0P1
100C01
1C0001
111111
