11111111111111
1P00000000C001
10C00000000001
100000E00000C1
100C0000C00001
100000C000C001
11111111111111
