111111
1CC0P1
101111
1C01E1
111111
