111111
1EC0PA
100C01
1C0001
111111
